@@@@@@@@@@@@@@@@@
@...............@
@.##.##...##.##.@
@.##.##...##.##.@
@.##.##...##.##.@
@.##.##...##.##.@
@...............@
@.##.##...##.##.@
@.##.##...##.##.@
@...............@
@.##.##...##.##.@
@.##.##...##.##.@
@...............@
@...##.....##...@
@......###......@
@......#.#......@
@@@@@@@@@@@@@@@@@
ENEMIES: bbbbbbbbbb