@@@@@@@@@@@@@@@@@
@...............@
@.@@@@@...@@@@@.@
@.#...........#.@
@.@@@@@...@@@@@.@
@...............@
@.#####...#####.@
@.#...........#.@
@.#####...#####.@
@...............@
@.@@@@@...@@@@@.@
@.#...........#.@
@.@@@@@...@@@@@.@
@...............@
@......###......@
@......#.#......@
@@@@@@@@@@@@@@@@@
ENEMIES: ffasfassfa