@@@@@@@@@@@@@@@@@
@...............@
@.@@@@.....@@@@.@
@.@@@@.....@@@@.@
@.@@@@.....@@@@.@
@...............@
@.##.##...##.##.@
@.##.##...##.##.@
@...............@
@.@@@@.....@@@@.@
@.@@@@.....@@@@.@
@...............@
@..###.....###..@
@..###.....###..@
@......###......@
@......#.#......@
@@@@@@@@@@@@@@@@@
ENEMIES: bbfbbfbbfb