@@@@@@@@@@@@@@@@@
@...............@
@.##.##...##.##.@
@.##.##...##.##.@
@~~~~~~...~~~~~~@
@~~~~~~...~~~~~~@
@...............@
@.##.##...##.##.@
@.##.##...##.##.@
@...............@
@~~~~~~...~~~~~~@
@~~~~~~...~~~~~~@
@...............@
@..###.....###..@
@......###......@
@......#.#......@
@@@@@@@@@@@@@@@@@
ENEMIES: aaabbaaabb