@@@@@@@@@@@@@@@@@
@...............@
@..%%%.....%%%..@
@..%%%.....%%%..@
@..%%%.....%%%..@
@.##.##...##.##.@
@.##.##...##.##.@
@...............@
@.%%%%%...%%%%%.@
@.%%%%%...%%%%%.@
@...............@
@.##.##...##.##.@
@.##.##...##.##.@
@...............@
@......###......@
@......#.#......@
@@@@@@@@@@@@@@@@@
ENEMIES: bbssbbssbb