@@@@@@@@@@@@@@@@
@..............@
@..###....###..@
@..###....###..@
@..###....###..@
@..............@
@..###....###..@
@..###....###..@
@......##......@
@..###.##.###..@
@..###.##.###..@
@..............@
@..###....###..@
@..###....###..@
@..............@
@@@@@@@@@@@@@@@@