@@@@@@@@@@@@@@@@
@..............@
@.#.#.#..#.#.#.@
@.#.#.#..#.#.#.@
@..............@
@..@.@.##.@.@..@
@..@.@.##.@.@..@
@..............@
@.##.##..##.##.@
@.##.##..##.##.@
@..............@
@..@.@.##.@.@..@
@..@.@.##.@.@..@
@..............@
@..............@
@@@@@@@@@@@@@@@@