@@@@@@@@@@@@@@@@
@..............@
@..~~~~..~~~~..@
@..~~~~..~~~~..@
@..####..####..@
@..............@
@~~~~~~..~~~~~~@
@~~~~~~..~~~~~~@
@..............@
@..####..####..@
@..~~~~..~~~~..@
@..~~~~..~~~~..@
@......##......@
@......##......@
@..............@
@@@@@@@@@@@@@@@@
ENEMIES: bssbbssbbs