@@@@@@@@@@@@@@@@
@..............@
@.###.####.###.@
@.#...#..#...#.@
@.###.#..#.###.@
@..............@
@.#.###..###.#.@
@.#.#......#.#.@
@.#.###..###.#.@
@..............@
@.###.#..#.###.@
@.#...#..#...#.@
@.###.####.###.@
@..............@
@..............@
@@@@@@@@@@@@@@@@
ENEMIES: bfbfbfbfbf