@@@@@@@@@@@@@@@@
@..............@
@..##..@...##..@
@..##..@...##..@
@..............@
@..@@@...@@@...@
@......#.......@
@..#####.#####.@
@......#.......@
@..@@@...@@@...@
@..............@
@..##..@...##..@
@..##..@...##..@
@......@.......@
@..............@
@@@@@@@@@@@@@@@@