@@@@@@@@@@@@@@@@
@..............@
@.#..#....#..#.@
@.#..#....#..#.@
@.#..#....#..#.@
@.|..|....|..|.@
@.#..#....#..#.@
@.#..#....#..#.@
@..............@
@.#..#....#..#.@
@.#..#....#..#.@
@.#..#....#..#.@
@.#..#....#..#.@
@.#..#....#..#.@
@..............@
@@@@@@@@@@@@@@@@
ENEMIES: fbfbfbfbff