@@@@@@@@@@@@@@@@
@..............@
@..##..@@..##..@
@..##..@@..##..@
@......@@......@
@..@@@@@@@@@@..@
@..@@..##..@@..@
@..@@..##..@@..@
@..@@......@@..@
@..@@..##..@@..@
@......##......@
@..##..##..##..@
@..##......##..@
@..##########..@
@..............@
@@@@@@@@@@@@@@@@