@@@@@@@@@@@@@@@@
@..............@
@.~~..####..~~.@
@.~~..####..~~.@
@.~~........~~.@
@.~~~~.##.~~~~.@
@......##......@
@..###.~~.###..@
@..###.~~.###..@
@......##......@
@.~~~~.##.~~~~.@
@.~~........~~.@
@.~~..####..~~.@
@.~~..####..~~.@
@..............@
@@@@@@@@@@@@@@@@