@@@@@@@@@@@@@@@@
@..............@
@.%%..####..%%.@
@.%%..####..%%.@
@.##..%%%%..##.@
@.....####.....@
@.%%..####..%%.@
@.%%........%%.@
@....@.##.@....@
@.%%........%%.@
@.%%..####..%%.@
@.....####.....@
@.##..%%%%..##.@
@.##..%%%%..##.@
@..............@
@@@@@@@@@@@@@@@@