@@@@@@@@@@@@@@@@@
@...............@
@.#..#.....#..#.@
@.#..#.....#..#.@
@.#..#.....#..#.@
@.|..|.....|..|.@
@.#..#.....#..#.@
@.#..#.....#..#.@
@...............@
@.#..#.....#..#.@
@.#..#.....#..#.@
@.#..#.....#..#.@
@.#..#.....#..#.@
@.#..#.....#..#.@
@.#..#.....#..#.@
@...............@
@@@@@@@@@@@@@@@@@
ENEMIES: fbfbfbfbff