@@@@@@@@@@@@@@@@
@..............@
@..%%%%..%%%%..@
@..%%%%..%%%%..@
@..%%%%..%%%%..@
@......##......@
@..%%%%..%%%%..@
@..%%%%..%%%%..@
@..%%%%..%%%%..@
@......##......@
@..%%%%..%%%%..@
@..%%%%..%%%%..@
@..%%%%..%%%%..@
@..............@
@..............@
@@@@@@@@@@@@@@@@
ENEMIES: bsssbsssbs