@@@@@@@@@@@@@@@@
@..............@
@..###....###..@
@..###....###..@
@~~~~~~..~~~~~~@
@~~~~~~..~~~~~~@
@..##......##..@
@..##..@@..##..@
@......@@......@
@..##......##..@
@~~~~~~..~~~~~~@
@~~~~~~..~~~~~~@
@..###....###..@
@..###....###..@
@..............@
@@@@@@@@@@@@@@@@