@@@@@@@@@@@@@@@@@
@...............@
@.@@@@.....@@@@.@
@.@...........@.@
@.@.@@@...@@@.@.@
@.@.@.......@.@.@
@...#.......#...@
@.@@@.......@@@.@
@...#.......#...@
@.@.@.......@.@.@
@.@.@@@@@@@@@.@.@
@.@...........@.@
@.@@@@.....@@@@.@
@...............@
@...............@
@...............@
@@@@@@@@@@@@@@@@@
ENEMIES: baabaaaba