@@@@@@@@@@@@@@@@@
@...............@
@.##..@@@@@..##.@
@.##..@...@..##.@
@.##..@...@..##.@
@.##..@...@..##.@
@.....@...@.....@
@.#####...#####.@
@.#####...#####.@
@.....@...@.....@
@.@@@.@...@.@@@.@
@.@...#...#...@.@
@.@...#...#...@.@
@.@...#####...@.@
@...............@
@...............@
@@@@@@@@@@@@@@@@@
ENEMIES: asaaasaas