@@@@@@@@@@@@@@@@@
@...............@
@.####.@@@.####.@
@.#..#.@.@.#..#.@
@.####.@@@.####.@
@......@@@......@
@.@@@@@@@@@@@@@.@
@.#############.@
@...............@
@.@@@@.....@@@@.@
@.####.....####.@
@.......#.......@
@.......#.......@
@.......#.......@
@...............@
@...............@
@@@@@@@@@@@@@@@@@
ENEMIES: asaaasaas