@@@@@@@@@@@@@@@@@
@...............@
@..~~~~...~~~~..@
@..~~~~...~~~~..@
@..####...####..@
@...............@
@~~~~~~...~~~~~~@
@~~~~~~...~~~~~~@
@...............@
@..####...####..@
@..~~~~...~~~~..@
@..~~~~...~~~~..@
@.......#.......@
@.......#.......@
@.......#.......@
@...............@
@@@@@@@@@@@@@@@@@
ENEMIES: bssbbssbbs