@@@@@@@@@@@@@@@@@
@...............@
@..@.........@..@
@...............@
@...............@
@.......@.......@
@......@@@......@
@......@@@......@
@...............@
@...............@
@......@@@......@
@......@@@......@
@.......@.......@
@...............@
@..@.........@..@
@...............@
@@@@@@@@@@@@@@@@@
ENEMIES: ffasfassfa