@@@@@@@@@@@@@@@@
@..............@
@.@..........@.@
@..............@
@...###..###...@
@.@.###..###.@.@
@..............@
@...@@@..@@@...@
@.......##.....@
@...@@@.##.@@@.@
@.......##.....@
@.@..........@.@
@...###..###...@
@...###..###...@
@..............@
@@@@@@@@@@@@@@@@