@@@@@@@@@@@@@@@@
@..............@
@.####.@@.####.@
@.#..#.@..#..#.@
@.####.@@.####.@
@......@@......@
@.@@@@@@@@@@@@.@
@.############.@
@..............@
@.@@@@....@@@@.@
@.####....####.@
@......##......@
@......##......@
@..............@
@..............@
@@@@@@@@@@@@@@@@
ENEMIES: asaaasaas