@@@@@@@@@@@@@@@@
@..............@
@.@@@@....@@@@.@
@.@..........@.@
@.@.@@@..@@@.@.@
@.@.@......@.@.@
@...#......#...@
@.@@@......@@@.@
@...#......#...@
@.@.@......@.@.@
@.@.@@@@@@@@.@.@
@.@..........@.@
@.@@@@....@@@@.@
@..............@
@..............@
@@@@@@@@@@@@@@@@
ENEMIES: baabaaaba