@@@@@@@@@@@@@@@@
@..............@
@.############.@
@.#..........#.@
@.#.########.#.@
@.#.#......#.#.@
@.#.#.####.#.#.@
@.#.#.#..#.#.#.@
@.#.#.#..#.#.#.@
@.#.#.####.#.#.@
@.#.#......#.#.@
@.#.########.#.@
@.#..........#.@
@.############.@
@..............@
@@@@@@@@@@@@@@@@