@@@@@@@@@@@@@@@@@
@...............@
@.@...........@.@
@...............@
@...###...###...@
@.@.###...###.@.@
@...............@
@...@@@...@@@...@
@.......#.......@
@...@@@.#.@@@...@
@.......#.......@
@.@...........@.@
@...###...###...@
@...###...###...@
@...............@
@...............@
@@@@@@@@@@@@@@@@@
ENEMIES: ffasfassfa