@@@@@@@@@@@@@@@@@
@...............@
@.###.#####.###.@
@.#...#...#...#.@
@.###.#...#.###.@
@...............@
@.#.###...###.#.@
@.#.#.......#.#.@
@.#.###...###.#.@
@...............@
@.###.#...#.###.@
@.#...#...#...#.@
@.###.#####.###.@
@...............@
@...............@
@...............@
@@@@@@@@@@@@@@@@@
ENEMIES: bfbfbfbfbf