@@@@@@@@@@@@@@@@
@..............@
@.##..@@@@..##.@
@.##..@..@..##.@
@.##..@..@..##.@
@.##..@..@..##.@
@.....@..@.....@
@.#####..#####.@
@.#####..#####.@
@.....@..@.....@
@.@@@.@..@.@@@.@
@.@...#..#...@.@
@.@...#..#...@.@
@.@...####...@.@
@..............@
@@@@@@@@@@@@@@@@