@@@@@@@@@@@@@@@@@
@...............@
@..%%%%...%%%%..@
@..%%%%...%%%%..@
@..%%%%...%%%%..@
@.......#.......@
@..%%%%...%%%%..@
@..%%%%...%%%%..@
@..%%%%...%%%%..@
@.......#.......@
@..%%%%...%%%%..@
@..%%%%...%%%%..@
@..%%%%...%%%%..@
@...............@
@...............@
@...............@
@@@@@@@@@@@@@@@@@
ENEMIES: bsssbsssbs