@@@@@@@@@@@@@@@@@
@...............@
@..###.....###..@
@..###.....###..@
@..###.....###..@
@...............@
@..###.....###..@
@..###.....###..@
@.......#.......@
@..###..#..###..@
@..###..#..###..@
@...............@
@..###.....###..@
@..###.....###..@
@..###.....###..@
@...............@
@@@@@@@@@@@@@@@@@
ENEMIES: bfb