@@@@@@@@@@@@@@@@
@..............@
@..@........@..@
@..............@
@..............@
@......@@......@
@......@@......@
@..............@
@..............@
@......@@......@
@......@@......@
@..............@
@..............@
@..@........@..@
@..............@
@@@@@@@@@@@@@@@@
ENEMIES: ffasfassfa